AG.LND.AGRI.K2	Agricultural land (sq. km)
AG.LND.AGRI.ZS	Agricultural land (% of land area)
AG.LND.ARBL.ZS	Arable land (% of land area)
AG.LND.EL5M.RU.K2	Rural land area where elevation is below 5 meters (sq. km)
AG.LND.EL5M.RU.ZS	Rural land area where elevation is below 5 meters (% of total land area)
AG.LND.EL5M.UR.K2	Urban land area where elevation is below 5 meters (sq. km)
AG.LND.EL5M.UR.ZS	Urban land area where elevation is below 5 meters (% of total land area)
AG.LND.EL5M.ZS	Land area where elevation is below 5 meters (% of total land area)
AG.LND.FRST.K2	Forest area (sq. km)
AG.LND.FRST.ZS	Forest area (% of land area)
AG.LND.IRIG.AG.ZS	Agricultural irrigated land (% of total agricultural land)
AG.LND.PRCP.MM	Average precipitation in depth (mm per year)
AG.LND.TOTL.K2	Land area (sq. km)
AG.LND.TOTL.RU.K2	Rural land area (sq. km)
AG.LND.TOTL.UR.K2	Urban land area (sq. km)
AG.SRF.TOTL.K2	Surface area (sq. km)
AG.YLD.CREL.KG	Cereal yield (kg per hectare)
BG.GSR.NFSV.GD.ZS	Trade in services (% of GDP)
BM.GSR.CMCP.ZS	Communications, computer, etc. (% of service imports, BoP)
BM.GSR.GNFS.CD	Imports of goods and services (BoP, current US$)
BM.GSR.INSF.ZS	Insurance and financial services (% of service imports, BoP)
BM.GSR.MRCH.CD	Goods imports (BoP, current US$)
BM.GSR.NFSV.CD	Service imports (BoP, current US$)
BM.GSR.ROYL.CD	Charges for the use of intellectual property, payments (BoP, current US$)
BM.GSR.TOTL.CD	Imports of goods, services and primary income (BoP, current US$)
BM.GSR.TRAN.ZS	Transport services (% of service imports, BoP)
BM.GSR.TRVL.ZS	Travel services (% of service imports, BoP)
BM.KLT.DINV.CD.WD	Foreign direct investment, net outflows (BoP, current US$)
BM.KLT.DINV.WD.GD.ZS	Foreign direct investment, net outflows (% of GDP)
BM.TRF.PWKR.CD.DT	Personal remittances, paid (current US$)
BN.CAB.XOKA.CD	Current account balance (BoP, current US$)
BN.GSR.GNFS.CD	Net trade in goods and services (BoP, current US$)
BN.GSR.MRCH.CD	Net trade in goods (BoP, current US$)
BN.KLT.DINV.CD	Foreign direct investment, net (BoP, current US$)
BN.KLT.PTXL.CD	Portfolio Investment, net (BoP, current US$)
BX.GRT.EXTA.CD.WD	Grants, excluding technical cooperation (BoP, current US$)
BX.GRT.TECH.CD.WD	Technical cooperation grants (BoP, current US$)
BX.GSR.CCIS.CD	ICT service exports (BoP, current US$)
BX.GSR.CCIS.ZS	ICT service exports (% of service exports, BoP)
BX.GSR.CMCP.ZS	Communications, computer, etc. (% of service exports, BoP)
BX.GSR.GNFS.CD	Exports of goods and services (BoP, current US$)
BX.GSR.INSF.ZS	Insurance and financial services (% of service exports, BoP)
BX.GSR.MRCH.CD	Goods exports (BoP, current US$)
BX.GSR.NFSV.CD	Service exports (BoP, current US$)
BX.GSR.ROYL.CD	Charges for the use of intellectual property, receipts (BoP, current US$)
BX.GSR.TOTL.CD	Exports of goods, services and primary income (BoP, current US$)
BX.GSR.TRAN.ZS	Transport services (% of service exports, BoP)
BX.GSR.TRVL.ZS	Travel services (% of service exports, BoP)
BX.KLT.DINV.CD.WD	Foreign direct investment, net inflows (BoP, current US$)
BX.KLT.DINV.WD.GD.ZS	Foreign direct investment, net inflows (% of GDP)
BX.KLT.DREM.CD.DT	Primary income on FDI, payments (current US$)
BX.PEF.TOTL.CD.WD	Portfolio equity, net inflows (BoP, current US$)
BX.TRF.PWKR.CD	Personal transfers, receipts (BoP, current US$)
BX.TRF.PWKR.CD.DT	Personal remittances, received (current US$)
BX.TRF.PWKR.DT.GD.ZS	Personal remittances, received (% of GDP)
DT.DIS.IDAG.CD	IDA grants (current US$)
DT.DOD.DECT.CD	External debt stocks, total (DOD, current US$)
DT.DOD.DECT.EX.ZS	External debt stocks (% of exports of goods, services and primary income)
DT.DOD.DECT.GN.ZS	External debt stocks (% of GNI)
DT.DOD.DSTC.IR.ZS	Short-term debt (% of total reserves)
DT.DOD.DSTC.XP.ZS	Short-term debt (% of exports of goods, services and primary income)
DT.DOD.MDRI.CD	Debt forgiveness grants (current US$)
DT.DOD.PVLX.CD	Present value of external debt (current US$)
DT.DOD.PVLX.EX.ZS	Present value of external debt (% of exports of goods, services and primary income)
DT.DOD.PVLX.GN.ZS	Present value of external debt (% of GNI)
DT.INT.DECT.EX.ZS	Interest payments on external debt (% of exports of goods, services and primary income)
DT.INT.DECT.GN.ZS	Interest payments on external debt (% of GNI)
DT.NFL.BOND.CD	Portfolio investment, bonds (PPG + PNG) (NFL, current US$)
DT.ODA.ODAT.CD	Net official development assistance received (current US$)
DT.ODA.ODAT.GN.ZS	Net ODA received (% of GNI)
DT.ODA.ODAT.PC.ZS	Net ODA received per capita (current US$)
DT.TDS.DECT.EX.ZS	Total debt service (% of exports of goods, services and primary income)
DT.TDS.DECT.GN.ZS	Total debt service (% of GNI)
EG.EGY.PRIM.PP.KD	Energy intensity level of primary energy (MJ/$2011 PPP GDP)
EG.ELC.ACCS.RU.ZS	Access to electricity, rural (% of rural population)
EG.ELC.ACCS.UR.ZS	Access to electricity, urban (% of urban population)
EG.ELC.ACCS.ZS	Access to electricity (% of population)
EG.ELC.COAL.ZS	Electricity production from coal sources (% of total)
EG.ELC.FOSL.ZS	Electricity production from oil, gas and coal sources (% of total)
EG.ELC.HYRO.ZS	Electricity production from hydroelectric sources (% of total)
EG.ELC.LOSS.ZS	Electric power transmission and distribution losses (% of output)
EG.ELC.NGAS.ZS	Electricity production from natural gas sources (% of total)
EG.ELC.NUCL.ZS	Electricity production from nuclear sources (% of total)
EG.ELC.PETR.ZS	Electricity production from oil sources (% of total)
EG.ELC.RNEW.ZS	Renewable electricity output (% of total electricity output)
EG.ELC.RNWX.KH	Electricity production from renewable sources, excluding hydroelectric (kWh)
EG.ELC.RNWX.ZS	Electricity production from renewable sources, excluding hydroelectric (% of total)
EG.FEC.RNEW.ZS	Renewable energy consumption (% of total final energy consumption)
EG.IMP.CONS.ZS	Energy imports, net (% of energy use)
EG.NSF.ACCS.RU.ZS	Access to non-solid fuel, rural (% of rural population)
EG.NSF.ACCS.UR.ZS	Access to non-solid fuel, urban (% of urban population)
EG.NSF.ACCS.ZS	Access to non-solid fuel (% of population)
EG.USE.COMM.GD.PP.KD	Energy use (kg of oil equivalent) per $1,000 GDP (constant 2011 PPP)
EG.USE.ELEC.KH.PC	Electric power consumption (kWh per capita)
EG.USE.PCAP.KG.OE	Energy use (kg of oil equivalent per capita)
EN.ATM.CO2E.EG.ZS	CO2 intensity (kg per kg of oil equivalent energy use)
EN.ATM.CO2E.GF.KT	CO2 emissions from gaseous fuel consumption (kt)
EN.ATM.CO2E.GF.ZS	CO2 emissions from gaseous fuel consumption (% of total)
EN.ATM.CO2E.KD.GD	CO2 emissions (kg per 2010 US$ of GDP)
EN.ATM.CO2E.KT	CO2 emissions (kt)
EN.ATM.CO2E.LF.KT	CO2 emissions from liquid fuel consumption (kt)
EN.ATM.CO2E.LF.ZS	CO2 emissions from liquid fuel consumption (% of total)
EN.ATM.CO2E.PC	CO2 emissions (metric tons per capita)
EN.ATM.CO2E.PP.GD	CO2 emissions (kg per PPP $ of GDP)
EN.ATM.CO2E.PP.GD.KD	CO2 emissions (kg per 2011 PPP $ of GDP)
EN.ATM.CO2E.SF.KT	CO2 emissions from solid fuel consumption (kt)
EN.ATM.CO2E.SF.ZS	CO2 emissions from solid fuel consumption (% of total)
EN.ATM.GHGO.KT.CE	Other greenhouse gas emissions, HFC, PFC and SF6 (thousand metric tons of CO2 equivalent)
EN.ATM.GHGO.ZG	Other greenhouse gas emissions (% change from 1990)
EN.ATM.GHGT.KT.CE	Total greenhouse gas emissions (kt of CO2 equivalent)
EN.ATM.GHGT.ZG	Total greenhouse gas emissions (% change from 1990)
EN.ATM.HFCG.KT.CE	HFC gas emissions (thousand metric tons of CO2 equivalent)
EN.ATM.METH.AG.KT.CE	Agricultural methane emissions (thousand metric tons of CO2 equivalent)
EN.ATM.METH.AG.ZS	Agricultural methane emissions (% of total)
EN.ATM.METH.EG.KT.CE	Methane emissions in energy sector (thousand metric tons of CO2 equivalent)
EN.ATM.METH.EG.ZS	Energy related methane emissions (% of total)
EN.ATM.METH.KT.CE	Methane emissions (kt of CO2 equivalent)
EN.ATM.METH.ZG	Methane emissions (% change from 1990)
EN.ATM.NOXE.AG.KT.CE	Agricultural nitrous oxide emissions (thousand metric tons of CO2 equivalent)
EN.ATM.NOXE.AG.ZS	Agricultural nitrous oxide emissions (% of total)
EN.ATM.NOXE.EG.KT.CE	Nitrous oxide emissions in energy sector (thousand metric tons of CO2 equivalent)
EN.ATM.NOXE.EG.ZS	Nitrous oxide emissions in energy sector (% of total)
EN.ATM.NOXE.KT.CE	Nitrous oxide emissions (thousand metric tons of CO2 equivalent)
EN.ATM.NOXE.ZG	Nitrous oxide emissions (% change from 1990)
EN.ATM.PFCG.KT.CE	PFC gas emissions (thousand metric tons of CO2 equivalent)
EN.ATM.PM25.MC.M3	PM2.5 air pollution, mean annual exposure (micrograms per cubic meter)
EN.ATM.PM25.MC.ZS	PM2.5 air pollution, population exposed to levels exceeding WHO guideline value (% of total)
EN.ATM.SF6G.KT.CE	SF6 gas emissions (thousand metric tons of CO2 equivalent)
EN.CLC.DRSK.XQ	Disaster risk reduction progress score (1-5 scale; 5=best)
EN.CLC.GHGR.MT.CE	GHG net emissions/removals by LUCF (Mt of CO2 equivalent)
EN.CLC.MDAT.ZS	Droughts, floods, extreme temperatures (% of population, average 1990-2009)
EN.POP.EL5M.RU.ZS	Rural population living in areas where elevation is below 5 meters (% of total population)
EN.POP.EL5M.UR.ZS	Urban population living in areas where elevation is below 5 meters (% of total population)
EN.POP.EL5M.ZS	Population living in areas where elevation is below 5 meters (% of total population)
EN.POP.SLUM.UR.ZS	Population living in slums (% of urban population)
EN.URB.MCTY.TL.ZS	Population in urban agglomerations of more than 1 million (% of total population)
EP.PMP.DESL.CD	Pump price for diesel fuel (US$ per liter)
EP.PMP.SGAS.CD	Pump price for gasoline (US$ per liter)
ER.H2O.FWAG.ZS	Annual freshwater withdrawals, agriculture (% of total freshwater withdrawal)
ER.H2O.FWDM.ZS	Annual freshwater withdrawals, domestic (% of total freshwater withdrawal)
ER.H2O.FWIN.ZS	Annual freshwater withdrawals, industry (% of total freshwater withdrawal)
ER.H2O.FWTL.K3	Annual freshwater withdrawals, total (billion cubic meters)
ER.H2O.FWTL.ZS	Annual freshwater withdrawals, total (% of internal resources)
ER.H2O.INTR.K3	Renewable internal freshwater resources, total (billion cubic meters)
ER.H2O.INTR.PC	Renewable internal freshwater resources per capita (cubic meters)
ER.LND.PTLD.ZS	Terrestrial protected areas (% of total land area)
ER.MRN.PTMR.ZS	Marine protected areas (% of territorial waters)
ER.PTD.TOTL.ZS	Terrestrial and marine protected areas (% of total territorial area)
FI.RES.TOTL.CD	Total reserves (includes gold, current US$)
FI.RES.TOTL.DT.ZS	Total reserves (% of total external debt)
FI.RES.TOTL.MO	Total reserves in months of imports
FI.RES.XGLD.CD	Total reserves minus gold (current US$)
FP.CPI.TOTL.ZG	Inflation, consumer prices (annual %)
FS.AST.PRVT.GD.ZS	Domestic credit to private sector (% of GDP)
GC.DOD.TOTL.GD.ZS	Central government debt, total (% of GDP)
GC.REV.XGRT.GD.ZS	Revenue, excluding grants (% of GDP)
GC.TAX.EXPT.ZS	Taxes on exports (% of tax revenue)
GC.TAX.IMPT.ZS	Customs and other import duties (% of tax revenue)
GC.XPN.TOTL.GD.ZS	Expense (% of GDP)
IC.BUS.EASE.XQ	Ease of doing business index (1=most business-friendly regulations)
IC.CRD.INFO.XQ	Depth of credit information index (0=low to 8=high)
IC.CRD.PRVT.ZS	Private credit bureau coverage (% of adults)
IC.CRD.PUBL.ZS	Public credit registry coverage (% of adults)
IC.CUS.DURS.EX	Average time to clear exports through customs (days)
IC.ELC.DURS	Delay in obtaining an electrical connection (days)
IC.ELC.TIME	Time required to get electricity (days)
IC.EXP.COST.CD	Cost to export (US$ per container)
IC.EXP.CSBC.CD	Cost to export, border compliance (US$)
IC.EXP.CSDC.CD	Cost to export, documentary compliance (US$)
IC.EXP.DOCS	Documents to export (number)
IC.EXP.DURS	Time to export (days)
IC.EXP.TMBC	Time to export, border compliance (hours)
IC.EXP.TMDC	Time to export, documentary compliance (hours)
IC.FRM.BNKS.ZS	Firms using banks to finance investment (% of firms)
IC.FRM.FEMM.ZS	Firms with female top manager (% of firms)
IC.FRM.FEMO.ZS	Firms with female participation in ownership (% of firms)
IC.FRM.OUTG.ZS	Value lost due to electrical outages (% of sales for affected firms)
IC.IMP.COST.CD	Cost to import (US$ per container)
IC.IMP.CSBC.CD	Cost to import, border compliance (US$)
IC.IMP.CSDC.CD	Cost to import, documentary compliance (US$)
IC.IMP.DOCS	Documents to import (number)
IC.IMP.DURS	Time to import (days)
IC.IMP.TMBC	Time to import, border compliance (hours)
IC.IMP.TMDC	Time to import, documentary compliance (hours)
IC.LGL.CRED.XQ	Strength of legal rights index (0=weak to 12=strong)
IC.TAX.DURS	Time to prepare and pay taxes (hours)
IC.TAX.PAYM	Tax payments (number)
IC.TAX.TOTL.CP.ZS	Total tax rate (% of commercial profits)
IE.PPI.ENGY.CD	Investment in energy with private participation (current US$)
IE.PPI.TELE.CD	Investment in telecoms with private participation (current US$)
IE.PPI.TRAN.CD	Investment in transport with private participation (current US$)
IE.PPI.WATR.CD	Investment in water and sanitation with private participation (current US$)
IQ.CPA.PUBS.XQ	CPIA public sector management and institutions cluster average (1=low to 6=high)
IS.ROD.PAVE.ZS	Roads, paved (% of total roads)
IS.VEH.NVEH.P3	Motor vehicles (per 1,000 people)
IS.VEH.PCAR.P3	Passenger cars (per 1,000 people)
IS.VEH.ROAD.K1	Vehicles (per km of road)
LP.EXP.DURS.MD	Lead time to export, median case (days)
LP.IMP.DURS.MD	Lead time to import, median case (days)
LP.LPI.CUST.XQ	Logistics performance index: Efficiency of customs clearance process (1=low to 5=high)
LP.LPI.INFR.XQ	Logistics performance index: Quality of trade and transport-related infrastructure (1=low to 5=high)
LP.LPI.ITRN.XQ	Logistics performance index: Ease of arranging competitively priced shipments (1=low to 5=high)
LP.LPI.LOGS.XQ	Logistics performance index: Competence and quality of logistics services (1=low to 5=high)
LP.LPI.OVRL.XQ	Logistics performance index: Overall (1=low to 5=high)
LP.LPI.TIME.XQ	Logistics performance index: Frequency with which shipments reach consignee within scheduled or expected time (1=low to 5=high)
LP.LPI.TRAC.XQ	Logistics performance index: Ability to track and trace consignments (1=low to 5=high)
MS.MIL.MPRT.KD	Arms imports (SIPRI trend indicator values)
MS.MIL.XPRT.KD	Arms exports (SIPRI trend indicator values)
NE.EXP.GNFS.CD	Exports of goods and services (current US$)
NE.EXP.GNFS.KD	Exports of goods and services (constant 2010 US$)
NE.EXP.GNFS.KD.ZG	Exports of goods and services (annual % growth)
NE.EXP.GNFS.ZS	Exports of goods and services (% of GDP)
NE.IMP.GNFS.CD	Imports of goods and services (current US$)
NE.IMP.GNFS.KD	Imports of goods and services (constant 2010 US$)
NE.IMP.GNFS.KD.ZG	Imports of goods and services (annual % growth)
NE.IMP.GNFS.ZS	Imports of goods and services (% of GDP)
NE.RSB.GNFS.CD	External balance on goods and services (current US$)
NE.RSB.GNFS.ZS	External balance on goods and services (% of GDP)
NE.TRD.GNFS.ZS	Trade (% of GDP)
NV.AGR.TOTL.CD	Agriculture, forestry, and fishing, value added (current US$)
NV.AGR.TOTL.ZS	Agriculture, forestry, and fishing, value added (% of GDP)
NY.ADJ.AEDU.CD	Adjusted savings: education expenditure (current US$)
NY.ADJ.AEDU.GN.ZS	Adjusted savings: education expenditure (% of GNI)
NY.ADJ.DCO2.CD	Adjusted savings: carbon dioxide damage (current US$)
NY.ADJ.DCO2.GN.ZS	Adjusted savings: carbon dioxide damage (% of GNI)
NY.ADJ.DFOR.CD	Adjusted savings: net forest depletion (current US$)
NY.ADJ.DFOR.GN.ZS	Adjusted savings: net forest depletion (% of GNI)
NY.ADJ.DKAP.CD	Adjusted savings: consumption of fixed capital (current US$)
NY.ADJ.DKAP.GN.ZS	Adjusted savings: consumption of fixed capital (% of GNI)
NY.ADJ.DMIN.CD	Adjusted savings: mineral depletion (current US$)
NY.ADJ.DMIN.GN.ZS	Adjusted savings: mineral depletion (% of GNI)
NY.ADJ.DNGY.CD	Adjusted savings: energy depletion (current US$)
NY.ADJ.DNGY.GN.ZS	Adjusted savings: energy depletion (% of GNI)
NY.ADJ.DPEM.CD	Adjusted savings: particulate emission damage (current US$)
NY.ADJ.DPEM.GN.ZS	Adjusted savings: particulate emission damage (% of GNI)
NY.ADJ.DRES.GN.ZS	Adjusted savings: natural resources depletion (% of GNI)
NY.ADJ.ICTR.GN.ZS	Adjusted savings: gross savings (% of GNI)
NY.ADJ.NNAT.CD	Adjusted savings: net national savings (current US$)
NY.ADJ.NNAT.GN.ZS	Adjusted savings: net national savings (% of GNI)
NY.ADJ.SVNG.CD	Adjusted net savings, including particulate emission damage (current US$)
NY.ADJ.SVNG.GN.ZS	Adjusted net savings, including particulate emission damage (% of GNI)
NY.ADJ.SVNX.CD	Adjusted net savings, excluding particulate emission damage (current US$)
NY.ADJ.SVNX.GN.ZS	Adjusted net savings, excluding particulate emission damage (% of GNI)
NY.EXP.CAPM.KN	Exports as a capacity to import (constant LCU)
NY.GDP.MINR.RT.ZS	Mineral rents (% of GDP)
NY.GDP.NGAS.RT.ZS	Natural gas rents (% of GDP)
NY.GDP.PETR.RT.ZS	Oil rents (% of GDP)
NY.GDP.TOTL.RT.ZS	Total natural resources rents (% of GDP)
NY.GNP.MKTP.CD	GNI (current US$)
PA.NUS.ATLS	DEC alternative conversion factor (LCU per US$)
SE.ADT.1524.LT.FE.ZS	Literacy rate, youth female (% of females ages 15-24)
SE.ADT.1524.LT.FM.ZS	Literacy rate, youth (ages 15-24), gender parity index (GPI)
SE.ADT.1524.LT.MA.ZS	Literacy rate, youth male (% of males ages 15-24)
SE.ADT.LITR.FE.ZS	Literacy rate, adult female (% of females ages 15 and above)
SE.ADT.LITR.MA.ZS	Literacy rate, adult male (% of males ages 15 and above)
SE.ENR.PRIM.FM.ZS	School enrollment, primary (gross), gender parity index (GPI)
SE.ENR.PRSC.FM.ZS	School enrollment, primary and secondary (gross), gender parity index (GPI)
SE.ENR.SECO.FM.ZS	School enrollment, secondary (gross), gender parity index (GPI)
SE.ENR.TERT.FM.ZS	School enrollment, tertiary (gross), gender parity index (GPI)
SE.PRE.ENRR.FE	School enrollment, preprimary, female (% gross)
SE.PRE.ENRR.MA	School enrollment, preprimary, male (% gross)
SE.PRM.CMPT.FE.ZS	Primary completion rate, female (% of relevant age group)
SE.PRM.CMPT.MA.ZS	Primary completion rate, male (% of relevant age group)
SE.PRM.CMPT.ZS	Primary completion rate, total (% of relevant age group)
SE.PRM.CUAT.FE.ZS	Educational attainment, at least completed primary, population 25+ years, female (%) (cumulative)
SE.PRM.CUAT.MA.ZS	Educational attainment, at least completed primary, population 25+ years, male (%) (cumulative)
SE.PRM.CUAT.ZS	Educational attainment, at least completed primary, population 25+ years, total (%) (cumulative)
SE.PRM.ENRL.FE.ZS	Primary education, pupils (% female)
SE.PRM.ENRR.FE	School enrollment, primary, female (% gross)
SE.PRM.ENRR.MA	School enrollment, primary, male (% gross)
SE.PRM.GINT.FE.ZS	Gross intake ratio in first grade of primary education, female (% of relevant age group)
SE.PRM.GINT.MA.ZS	Gross intake ratio in first grade of primary education, male (% of relevant age group)
SE.PRM.NENR.FE	School enrollment, primary, female (% net)
SE.PRM.NENR.MA	School enrollment, primary, male (% net)
SE.PRM.NINT.FE.ZS	Net intake rate in grade 1, female (% of official school-age population)
SE.PRM.NINT.MA.ZS	Net intake rate in grade 1, male (% of official school-age population)
SE.PRM.PRS5.FE.ZS	Persistence to grade 5, female (% of cohort)
SE.PRM.PRS5.MA.ZS	Persistence to grade 5, male (% of cohort)
SE.PRM.PRSL.FE.ZS	Persistence to last grade of primary, female (% of cohort)
SE.PRM.PRSL.MA.ZS	Persistence to last grade of primary, male (% of cohort)
SE.PRM.REPT.FE.ZS	Repeaters, primary, female (% of female enrollment)
SE.PRM.REPT.MA.ZS	Repeaters, primary, male (% of male enrollment)
SE.PRM.TCAQ.FE.ZS	Trained teachers in primary education, female (% of female teachers)
SE.PRM.TCAQ.MA.ZS	Trained teachers in primary education, male (% of male teachers)
SE.PRM.TCHR.FE.ZS	Primary education, teachers (% female)
SE.PRM.TENR.FE	Adjusted net enrollment rate, primary, female (% of primary school age children)
SE.PRM.TENR.MA	Adjusted net enrollment rate, primary, male (% of primary school age children)
SE.PRM.UNER.FE	Children out of school, primary, female
SE.PRM.UNER.MA	Children out of school, primary, male
SE.SEC.CUAT.LO.FE.ZS	Educational attainment, at least completed lower secondary, population 25+, female (%) (cumulative)
SE.SEC.CUAT.LO.MA.ZS	Educational attainment, at least completed lower secondary, population 25+, male (%) (cumulative)
SE.SEC.CUAT.LO.ZS	Educational attainment, at least completed lower secondary, population 25+, total (%) (cumulative)
SE.SEC.CUAT.PO.FE.ZS	Educational attainment, at least completed post-secondary, population 25+, female (%) (cumulative)
SE.SEC.CUAT.PO.MA.ZS	Educational attainment, at least completed post-secondary, population 25+, male (%) (cumulative)
SE.SEC.CUAT.PO.ZS	Educational attainment, at least completed post-secondary, population 25+, total (%) (cumulative)
SE.SEC.CUAT.UP.FE.ZS	Educational attainment, at least completed upper secondary, population 25+, female (%) (cumulative)
SE.SEC.CUAT.UP.MA.ZS	Educational attainment, at least completed upper secondary, population 25+, male (%) (cumulative)
SE.SEC.CUAT.UP.ZS	Educational attainment, at least completed upper secondary, population 25+, total (%) (cumulative)
SE.SEC.ENRL.FE.ZS	Secondary education, pupils (% female)
SE.SEC.ENRL.GC.FE.ZS	Secondary education, general pupils (% female)
SE.SEC.ENRL.VO.FE.ZS	Secondary education, vocational pupils (% female)
SE.SEC.ENRR.FE	School enrollment, secondary, female (% gross)
SE.SEC.ENRR.MA	School enrollment, secondary, male (% gross)
SE.SEC.NENR.FE	School enrollment, secondary, female (% net)
SE.SEC.NENR.MA	School enrollment, secondary, male (% net)
SE.SEC.PROG.FE.ZS	Progression to secondary school, female (%)
SE.SEC.PROG.MA.ZS	Progression to secondary school, male (%)
SE.SEC.TCHR.FE.ZS	Secondary education, teachers (% female)
SE.TER.CUAT.BA.FE.ZS	Educational attainment, at least Bachelor's or equivalent, population 25+, female (%) (cumulative)
SE.TER.CUAT.BA.MA.ZS	Educational attainment, at least Bachelor's or equivalent, population 25+, male (%) (cumulative)
SE.TER.CUAT.BA.ZS	Educational attainment, at least Bachelor's or equivalent, population 25+, total (%) (cumulative)
SE.TER.CUAT.DO.FE.ZS	Educational attainment, Doctoral or equivalent, population 25+, female (%) (cumulative)
SE.TER.CUAT.DO.MA.ZS	Educational attainment, Doctoral or equivalent, population 25+, male (%) (cumulative)
SE.TER.CUAT.DO.ZS	Educational attainment, Doctoral or equivalent, population 25+, total (%) (cumulative)
SE.TER.CUAT.MS.FE.ZS	Educational attainment, at least Master's or equivalent, population 25+, female (%) (cumulative)
SE.TER.CUAT.MS.MA.ZS	Educational attainment, at least Master's or equivalent, population 25+, male (%) (cumulative)
SE.TER.CUAT.MS.ZS	Educational attainment, at least Master's or equivalent, population 25+, total (%) (cumulative)
SE.TER.CUAT.ST.FE.ZS	Educational attainment, at least completed short-cycle tertiary, population 25+, female (%) (cumulative)
SE.TER.CUAT.ST.MA.ZS	Educational attainment, at least completed short-cycle tertiary, population 25+, male (%) (cumulative)
SE.TER.CUAT.ST.ZS	Educational attainment, at least completed short-cycle tertiary, population 25+, total (%) (cumulative)
SE.TER.ENRR.FE	School enrollment, tertiary, female (% gross)
SE.TER.ENRR.MA	School enrollment, tertiary, male (% gross)
SG.GEN.PARL.ZS	Proportion of seats held by women in national parliaments (%)
SG.JOB.NOPN.EQ	Nonpregnant and nonnursing women can do the same jobs as men (1=yes; 0=no)
SG.LAW.CHMR	Law prohibits or invalidates child or early marriage (1=yes; 0=no)
SG.LAW.EQRM.WK	Law mandates equal remuneration for females and males for work of equal value (1=yes; 0=no)
SG.LAW.LEVE.PU	Law mandates paid or unpaid maternity leave (1=yes; 0=no)
SG.LAW.NODC.HR	Law mandates nondiscrimination based on gender in hiring (1=yes; 0=no)
SG.LEG.DVAW	Legislation exists on domestic violence (1=yes; 0=no)
SG.MMR.LEVE.EP	Mothers are guaranteed an equivalent position after maternity leave (1=yes; 0=no)
SG.NOD.CONS	Nondiscrimination clause mentions gender in the constitution (1=yes; 0=no)
SG.VAW.1549.ZS	Proportion of women subjected to physical and/or sexual violence in the last 12 months (% of women age 15-49)
SG.VAW.ARGU.ZS	Women who believe a husband is justified in beating his wife when she argues with him (%)
SG.VAW.BURN.ZS	Women who believe a husband is justified in beating his wife when she burns the food (%)
SG.VAW.GOES.ZS	Women who believe a husband is justified in beating his wife when she goes out without telling him (%)
SG.VAW.NEGL.ZS	Women who believe a husband is justified in beating his wife when she neglects the children (%)
SG.VAW.REAS.ZS	Women who believe a husband is justified in beating his wife (any of five reasons) (%)
SG.VAW.REFU.ZS	Women who believe a husband is justified in beating his wife when she refuses sex with him (%)
SH.CON.1524.FE.ZS	Condom use, population ages 15-24, female (% of females ages 15-24)
SH.CON.1524.MA.ZS	Condom use, population ages 15-24, male (% of males ages 15-24)
SH.DYN.AIDS.FE.ZS	Women's share of population ages 15+ living with HIV (%)
SH.DYN.AIDS.ZS	Prevalence of HIV, total (% of population ages 15-49)
SH.DYN.CHLD.FE	Mortality rate, female child (per 1,000 female children age one)
SH.DYN.CHLD.MA	Mortality rate, male child (per 1,000 male children age one)
SH.DYN.MORT	Mortality rate, under-5 (per 1,000 live births)
SH.H2O.BASW.RU.ZS	People using at least basic drinking water services, rural (% of rural population)
SH.H2O.BASW.UR.ZS	People using at least basic drinking water services, urban (% of urban population)
SH.H2O.BASW.ZS	People using at least basic drinking water services (% of population)
SH.H2O.SAFE.RU.ZS	Improved water source, rural (% of rural population with access)
SH.H2O.SAFE.UR.ZS	Improved water source, urban (% of urban population with access)
SH.H2O.SAFE.ZS	Improved water source (% of population with access)
SH.H2O.SMDW.RU.ZS	People using safely managed drinking water services, rural (% of rural population)
SH.H2O.SMDW.UR.ZS	People using safely managed drinking water services, urban (% of urban population)
SH.H2O.SMDW.ZS	People using safely managed drinking water services (% of population)
SH.HIV.1524.FE.ZS	Prevalence of HIV, female (% ages 15-24)
SH.HIV.1524.MA.ZS	Prevalence of HIV, male (% ages 15-24)
SH.MED.CMHW.P3	Community health workers (per 1,000 people)
SH.MLR.INCD	Notified cases of malaria (per 100,000 people)
SH.MMR.RISK	Lifetime risk of maternal death (1 in: rate varies by country)
SH.MMR.RISK.ZS	Lifetime risk of maternal death (%)
SH.PRV.SMOK.FE	Smoking prevalence, females (% of adults)
SH.PRV.SMOK.MA	Smoking prevalence, males (% of adults)
SH.STA.ACSN	Improved sanitation facilities (% of population with access)
SH.STA.ACSN.RU	Improved sanitation facilities, rural (% of rural population with access)
SH.STA.ACSN.UR	Improved sanitation facilities, urban (% of urban population with access)
SH.STA.AIRP.P5	Mortality rate attributed to household and ambient air pollution, age-standardized (per 100,000 population)
SH.STA.ANVC.ZS	Pregnant women receiving prenatal care (%)
SH.STA.BASS.RU.ZS	People using at least basic sanitation services, rural (% of rural population)
SH.STA.BASS.UR.ZS	People using at least basic sanitation services, urban (% of urban population)
SH.STA.BASS.ZS	People using at least basic sanitation services (% of population)
SH.STA.BRTC.ZS	Births attended by skilled health staff (% of total)
SH.STA.HYGN.RU.ZS	People with basic handwashing facilities including soap and water, rural (% of rural population)
SH.STA.HYGN.UR.ZS	People with basic handwashing facilities including soap and water, urban (% of urban population)
SH.STA.HYGN.ZS	People with basic handwashing facilities including soap and water (% of population)
SH.STA.MALN.FE.ZS	Prevalence of underweight, weight for age, female (% of children under 5)
SH.STA.MALN.MA.ZS	Prevalence of underweight, weight for age, male (% of children under 5)
SH.STA.MALN.ZS	Prevalence of underweight, weight for age (% of children under 5)
SH.STA.MMRT	Maternal mortality ratio (modeled estimate, per 100,000 live births)
SH.STA.MMRT.NE	Maternal mortality ratio (national estimate, per 100,000 live births)
SH.STA.ODFC.RU.ZS	People practicing open defecation, rural (% of rural population)
SH.STA.ODFC.UR.ZS	People practicing open defecation, urban (% of urban population)
SH.STA.ODFC.ZS	People practicing open defecation (% of population)
SH.STA.POIS.P5	Mortality rate attributed to unintentional poisoning (per 100,000 population)
SH.STA.POIS.P5.FE	Mortality rate attributed to unintentional poisoning, female (per 100,000 female population)
SH.STA.POIS.P5.MA	Mortality rate attributed to unintentional poisoning, male (per 100,000 male population)
SH.STA.SMSS.RU.ZS	People using safely managed sanitation services, rural (% of rural population)
SH.STA.SMSS.UR.ZS	People using safely managed sanitation services, urban (% of urban population)
SH.STA.SMSS.ZS	People using safely managed sanitation services (% of population)
SH.STA.STNT.ZS	Prevalence of stunting, height for age (% of children under 5)
SH.STA.TRAF.P5	Mortality caused by road traffic injury (per 100,000 people)
SH.STA.WASH.P5	Mortality rate attributed to unsafe water, unsafe sanitation and lack of hygiene (per 100,000 population)
SH.TBS.INCD	Incidence of tuberculosis (per 100,000 people)
SI.DST.FRST.20	Income share held by lowest 20%
SI.POV.DDAY	Poverty headcount ratio at $1.90 a day (2011 PPP) (% of population)
SI.POV.RUGP	Rural poverty gap at national poverty lines (%)
SI.POV.RUHC	Rural poverty headcount ratio at national poverty lines (% of rural population)
SI.POV.URGP	Urban poverty gap at national poverty lines (%)
SI.POV.URHC	Urban poverty headcount ratio at national poverty lines (% of urban population)
SL.AGR.0714.FE.ZS	Child employment in agriculture, female (% of female economically active children ages 7-14)
SL.AGR.0714.MA.ZS	Child employment in agriculture, male (% of male economically active children ages 7-14)
SL.AGR.EMPL.FE.ZS	Employment in agriculture, female (% of female employment) (modeled ILO estimate)
SL.AGR.EMPL.MA.ZS	Employment in agriculture, male (% of male employment) (modeled ILO estimate)
SL.AGR.EMPL.ZS	Employment in agriculture (% of total employment) (modeled ILO estimate)
SL.EMP.1524.SP.FE.ZS	Employment to population ratio, ages 15-24, female (%) (modeled ILO estimate)
SL.EMP.1524.SP.MA.ZS	Employment to population ratio, ages 15-24, male (%) (modeled ILO estimate)
SL.EMP.INSV.FE.ZS	Share of women in wage employment in the nonagricultural sector (% of total nonagricultural employment)
SL.EMP.MPYR.FE.ZS	Employers, female (% of female employment) (modeled ILO estimate)
SL.EMP.MPYR.MA.ZS	Employers, male (% of male employment) (modeled ILO estimate)
SL.EMP.SELF.FE.ZS	Self-employed, female (% of female employment) (modeled ILO estimate)
SL.EMP.SELF.MA.ZS	Self-employed, male (% of male employment) (modeled ILO estimate)
SL.EMP.TOTL.SP.FE.ZS	Employment to population ratio, 15+, female (%) (modeled ILO estimate)
SL.EMP.TOTL.SP.MA.ZS	Employment to population ratio, 15+, male (%) (modeled ILO estimate)
SL.EMP.VULN.FE.ZS	Vulnerable employment, female (% of female employment) (modeled ILO estimate)
SL.EMP.VULN.MA.ZS	Vulnerable employment, male (% of male employment) (modeled ILO estimate)
SL.EMP.VULN.ZS	Vulnerable employment, total (% of total employment) (modeled ILO estimate)
SL.EMP.WORK.FE.ZS	Wage and salaried workers, female (% of female employment) (modeled ILO estimate)
SL.EMP.WORK.MA.ZS	Wage and salaried workers, male (% of male employment) (modeled ILO estimate)
SL.FAM.WORK.FE.ZS	Contributing family workers, female (% of female employment) (modeled ILO estimate)
SL.FAM.WORK.MA.ZS	Contributing family workers, male (% of male employment) (modeled ILO estimate)
SL.IND.EMPL.FE.ZS	Employment in industry, female (% of female employment) (modeled ILO estimate)
SL.IND.EMPL.MA.ZS	Employment in industry, male (% of male employment) (modeled ILO estimate)
SL.MNF.0714.FE.ZS	Child employment in manufacturing, female (% of female economically active children ages 7-14)
SL.MNF.0714.MA.ZS	Child employment in manufacturing, male (% of male economically active children ages 7-14)
SL.MNF.WAGE.FM	Ratio of female to male wages in manufacturing (%)
SL.SRV.0714.FE.ZS	Child employment in services, female (% of female economically active children ages 7-14)
SL.SRV.0714.MA.ZS	Child employment in services, male (% of male economically active children ages 7-14)
SL.SRV.EMPL.FE.ZS	Employment in services, female (% of female employment) (modeled ILO estimate)
SL.SRV.EMPL.MA.ZS	Employment in services, male (% of male employment) (modeled ILO estimate)
SL.TLF.0714.FE.ZS	Children in employment, female (% of female children ages 7-14)
SL.TLF.0714.MA.ZS	Children in employment, male (% of male children ages 7-14)
SL.TLF.0714.SW.FE.ZS	Children in employment, study and work, female (% of female children in employment, ages 7-14)
SL.TLF.0714.SW.MA.ZS	Children in employment, study and work, male (% of male children in employment, ages 7-14)
SL.TLF.0714.SW.ZS	Children in employment, study and work (% of children in employment, ages 7-14)
SL.TLF.0714.WK.FE.ZS	Children in employment, work only, female (% of female children in employment, ages 7-14)
SL.TLF.0714.WK.MA.ZS	Children in employment, work only, male (% of male children in employment, ages 7-14)
SL.TLF.0714.WK.ZS	Children in employment, work only (% of children in employment, ages 7-14)
SL.TLF.0714.ZS	Children in employment, total (% of children ages 7-14)
SL.TLF.ACTI.1524.FE.ZS	Labor force participation rate for ages 15-24, female (%) (modeled ILO estimate)
SL.TLF.ACTI.1524.MA.ZS	Labor force participation rate for ages 15-24, male (%) (modeled ILO estimate)
SL.TLF.ACTI.1524.ZS	Labor force participation rate for ages 15-24, total (%) (modeled ILO estimate)
SL.TLF.ACTI.FE.ZS	Labor force participation rate, female (% of female population ages 15-64) (modeled ILO estimate)
SL.TLF.ACTI.MA.ZS	Labor force participation rate, male (% of male population ages 15-64) (modeled ILO estimate)
SL.TLF.ACTI.ZS	Labor force participation rate, total (% of total population ages 15-64) (modeled ILO estimate)
SL.TLF.CACT.FE.ZS	Labor force participation rate, female (% of female population ages 15+) (modeled ILO estimate)
SL.TLF.CACT.MA.ZS	Labor force participation rate, male (% of male population ages 15+) (modeled ILO estimate)
SL.TLF.PART.FE.ZS	Part time employment, female (% of total female employment)
SL.TLF.PART.MA.ZS	Part time employment, male (% of total male employment)
SL.TLF.PART.TL.FE.ZS	Part time employment, female (% of total part time employment)
SL.TLF.PRIM.FE.ZS	Labor force with primary education, female (% of female labor force)
SL.TLF.PRIM.MA.ZS	Labor force with primary education, male (% of male labor force)
SL.TLF.PRIM.ZS	Labor force with primary education (% of total)
SL.TLF.SECO.FE.ZS	Labor force with secondary education, female (% of female labor force)
SL.TLF.SECO.MA.ZS	Labor force with secondary education, male (% of male labor force)
SL.TLF.SECO.ZS	Labor force with secondary education (% of total)
SL.TLF.TERT.FE.ZS	Labor force with tertiary education, female (% of female labor force)
SL.TLF.TERT.MA.ZS	Labor force with tertiary education, male (% of male labor force)
SL.TLF.TERT.ZS	Labor force with tertiary education (% of total)
SL.TLF.TOTL.FE.ZS	Labor force, female (% of total labor force)
SL.TLF.TOTL.IN	Labor force, total
SL.UEM.1524.FE.ZS	Unemployment, youth female (% of female labor force ages 15-24) (modeled ILO estimate)
SL.UEM.1524.MA.ZS	Unemployment, youth male (% of male labor force ages 15-24) (modeled ILO estimate)
SL.UEM.LTRM.FE.ZS	Long-term unemployment, female (% of female unemployment)
SL.UEM.LTRM.MA.ZS	Long-term unemployment, male (% of male unemployment)
SL.UEM.PRIM.FE.ZS	Unemployment with primary education, female (% of female unemployment)
SL.UEM.PRIM.MA.ZS	Unemployment with primary education, male (% of male unemployment)
SL.UEM.SECO.FE.ZS	Unemployment with secondary education, female (% of female unemployment)
SL.UEM.SECO.MA.ZS	Unemployment with secondary education, male (% of male unemployment)
SL.UEM.TERT.FE.ZS	Unemployment with tertiary education, female (% of female unemployment)
SL.UEM.TERT.MA.ZS	Unemployment with tertiary education, male (% of male unemployment)
SL.UEM.TOTL.FE.ZS	Unemployment, female (% of female labor force) (modeled ILO estimate)
SL.UEM.TOTL.MA.ZS	Unemployment, male (% of male labor force) (modeled ILO estimate)
SL.UEM.TOTL.ZS	Unemployment, total (% of total labor force) (modeled ILO estimate)
SM.EMI.TERT.ZS	Emigration rate of tertiary educated (% of total tertiary educated population)
SM.POP.NETM	Net migration
SM.POP.REFG	Refugee population by country or territory of asylum
SM.POP.REFG.OR	Refugee population by country or territory of origin
SM.POP.TOTL	International migrant stock, total
SM.POP.TOTL.ZS	International migrant stock (% of population)
SP.ADO.TFRT	Adolescent fertility rate (births per 1,000 women ages 15-19)
SP.DYN.AMRT.FE	Mortality rate, adult, female (per 1,000 female adults)
SP.DYN.AMRT.MA	Mortality rate, adult, male (per 1,000 male adults)
SP.DYN.CONU.ZS	Contraceptive prevalence, any methods (% of women ages 15-49)
SP.DYN.LE00.FE.IN	Life expectancy at birth, female (years)
SP.DYN.LE00.MA.IN	Life expectancy at birth, male (years)
SP.DYN.TFRT.IN	Fertility rate, total (births per woman)
SP.DYN.TO65.FE.ZS	Survival to age 65, female (% of cohort)
SP.DYN.TO65.MA.ZS	Survival to age 65, male (% of cohort)
SP.DYN.WFRT	Wanted fertility rate (births per woman)
SP.HOU.FEMA.ZS	Female headed households (% of households with a female head)
SP.M15.2024.FE.ZS	Women who were first married by age 15 (% of women ages 20-24)
SP.M18.2024.FE.ZS	Women who were first married by age 18 (% of women ages 20-24)
SP.MTR.1519.ZS	Teenage mothers (% of women ages 15-19 who have had children or are currently pregnant)
SP.POP.0014.TO.ZS	Population ages 0-14 (% of total)
SP.POP.1564.TO.ZS	Population ages 15-64 (% of total)
SP.POP.GROW	Population growth (annual %)
SP.POP.TOTL	Population, total
SP.URB.GROW	Urban population growth (annual %)
SP.URB.TOTL	Urban population
SP.URB.TOTL.IN.ZS	Urban population (% of total)
ST.INT.ARVL	International tourism, number of arrivals
ST.INT.DPRT	International tourism, number of departures
ST.INT.RCPT.CD	International tourism, receipts (current US$)
ST.INT.RCPT.XP.ZS	International tourism, receipts (% of total exports)
ST.INT.TRNR.CD	International tourism, receipts for passenger transport items (current US$)
ST.INT.TRNX.CD	International tourism, expenditures for passenger transport items (current US$)
ST.INT.TVLR.CD	International tourism, receipts for travel items (current US$)
ST.INT.TVLX.CD	International tourism, expenditures for travel items (current US$)
ST.INT.XPND.CD	International tourism, expenditures (current US$)
ST.INT.XPND.MP.ZS	International tourism, expenditures (% of total imports)
TG.VAL.TOTL.GD.ZS	Merchandise trade (% of GDP)
TM.QTY.MRCH.XD.WD	Import volume index (2000 = 100)
TM.TAX.MANF.BC.ZS	Binding coverage, manufactured products (%)
TM.TAX.MANF.BR.ZS	Bound rate, simple mean, manufactured products (%)
TM.TAX.MANF.IP.ZS	Share of tariff lines with international peaks, manufactured products (%)
TM.TAX.MANF.SM.AR.ZS	Tariff rate, applied, simple mean, manufactured products (%)
TM.TAX.MANF.SM.FN.ZS	Tariff rate, most favored nation, simple mean, manufactured products (%)
TM.TAX.MANF.SR.ZS	Share of tariff lines with specific rates, manufactured products (%)
TM.TAX.MANF.WM.AR.ZS	Tariff rate, applied, weighted mean, manufactured products (%)
TM.TAX.MANF.WM.FN.ZS	Tariff rate, most favored nation, weighted mean, manufactured products (%)
TM.TAX.MRCH.BC.ZS	Binding coverage, all products (%)
TM.TAX.MRCH.BR.ZS	Bound rate, simple mean, all products (%)
TM.TAX.MRCH.IP.ZS	Share of tariff lines with international peaks, all products (%)
TM.TAX.MRCH.SM.AR.ZS	Tariff rate, applied, simple mean, all products (%)
TM.TAX.MRCH.SM.FN.ZS	Tariff rate, most favored nation, simple mean, all products (%)
TM.TAX.MRCH.SR.ZS	Share of tariff lines with specific rates, all products (%)
TM.TAX.MRCH.WM.AR.ZS	Tariff rate, applied, weighted mean, all products (%)
TM.TAX.MRCH.WM.FN.ZS	Tariff rate, most favored nation, weighted mean, all products (%)
TM.TAX.TCOM.BC.ZS	Binding coverage, primary products (%)
TM.TAX.TCOM.BR.ZS	Bound rate, simple mean, primary products (%)
TM.TAX.TCOM.IP.ZS	Share of tariff lines with international peaks, primary products (%)
TM.TAX.TCOM.SM.AR.ZS	Tariff rate, applied, simple mean, primary products (%)
TM.TAX.TCOM.SM.FN.ZS	Tariff rate, most favored nation, simple mean, primary products (%)
TM.TAX.TCOM.SR.ZS	Share of tariff lines with specific rates, primary products (%)
TM.TAX.TCOM.WM.AR.ZS	Tariff rate, applied, weighted mean, primary products (%)
TM.TAX.TCOM.WM.FN.ZS	Tariff rate, most favored nation, weighted mean, primary products (%)
TM.VAL.AGRI.ZS.UN	Agricultural raw materials imports (% of merchandise imports)
TM.VAL.FOOD.ZS.UN	Food imports (% of merchandise imports)
TM.VAL.FUEL.ZS.UN	Fuel imports (% of merchandise imports)
TM.VAL.ICTG.ZS.UN	ICT goods imports (% total goods imports)
TM.VAL.INSF.ZS.WT	Insurance and financial services (% of commercial service imports)
TM.VAL.MANF.ZS.UN	Manufactures imports (% of merchandise imports)
TM.VAL.MMTL.ZS.UN	Ores and metals imports (% of merchandise imports)
TM.VAL.MRCH.AL.ZS	Merchandise imports from economies in the Arab World (% of total merchandise imports)
TM.VAL.MRCH.CD.WT	Merchandise imports (current US$)
TM.VAL.MRCH.HI.ZS	Merchandise imports from high-income economies (% of total merchandise imports)
TM.VAL.MRCH.OR.ZS	Merchandise imports from low- and middle-income economies outside region (% of total merchandise imports)
TM.VAL.MRCH.R1.ZS	Merchandise imports from low- and middle-income economies in East Asia &amp; Pacific (% of total merchandise imports)
TM.VAL.MRCH.R2.ZS	Merchandise imports from low- and middle-income economies in Europe &amp; Central Asia (% of total merchandise imports)
TM.VAL.MRCH.R3.ZS	Merchandise imports from low- and middle-income economies in Latin America &amp; the Caribbean (% of total merchandise imports)
TM.VAL.MRCH.R4.ZS	Merchandise imports from low- and middle-income economies in Middle East &amp; North Africa (% of total merchandise imports)
TM.VAL.MRCH.R5.ZS	Merchandise imports from low- and middle-income economies in South Asia (% of total merchandise imports)
TM.VAL.MRCH.R6.ZS	Merchandise imports from low- and middle-income economies in Sub-Saharan Africa (% of total merchandise imports)
TM.VAL.MRCH.RS.ZS	Merchandise imports by the reporting economy, residual (% of total merchandise imports)
TM.VAL.MRCH.WL.CD	Merchandise imports by the reporting economy (current US$)
TM.VAL.MRCH.WR.ZS	Merchandise imports from low- and middle-income economies within region (% of total merchandise imports)
TM.VAL.MRCH.XD.WD	Import value index (2000 = 100)
TM.VAL.OTHR.ZS.WT	Computer, communications and other services (% of commercial service imports)
TM.VAL.SERV.CD.WT	Commercial service imports (current US$)
TM.VAL.TRAN.ZS.WT	Transport services (% of commercial service imports)
TM.VAL.TRVL.ZS.WT	Travel services (% of commercial service imports)
TT.PRI.MRCH.XD.WD	Net barter terms of trade index (2000 = 100)
TX.QTY.MRCH.XD.WD	Export volume index (2000 = 100)
TX.VAL.AGRI.ZS.UN	Agricultural raw materials exports (% of merchandise exports)
TX.VAL.FOOD.ZS.UN	Food exports (% of merchandise exports)
TX.VAL.FUEL.ZS.UN	Fuel exports (% of merchandise exports)
TX.VAL.ICTG.ZS.UN	ICT goods exports (% of total goods exports)
TX.VAL.INSF.ZS.WT	Insurance and financial services (% of commercial service exports)
TX.VAL.MANF.ZS.UN	Manufactures exports (% of merchandise exports)
TX.VAL.MMTL.ZS.UN	Ores and metals exports (% of merchandise exports)
TX.VAL.MRCH.AL.ZS	Merchandise exports to economies in the Arab World (% of total merchandise exports)
TX.VAL.MRCH.CD.WT	Merchandise exports (current US$)
TX.VAL.MRCH.HI.ZS	Merchandise exports to high-income economies (% of total merchandise exports)
TX.VAL.MRCH.OR.ZS	Merchandise exports to low- and middle-income economies outside region (% of total merchandise exports)
TX.VAL.MRCH.R1.ZS	Merchandise exports to low- and middle-income economies in East Asia &amp; Pacific (% of total merchandise exports)
TX.VAL.MRCH.R2.ZS	Merchandise exports to low- and middle-income economies in Europe &amp; Central Asia (% of total merchandise exports)
TX.VAL.MRCH.R3.ZS	Merchandise exports to low- and middle-income economies in Latin America &amp; the Caribbean (% of total merchandise exports)
TX.VAL.MRCH.R4.ZS	Merchandise exports to low- and middle-income economies in Middle East &amp; North Africa (% of total merchandise exports)
TX.VAL.MRCH.R5.ZS	Merchandise exports to low- and middle-income economies in South Asia (% of total merchandise exports)
TX.VAL.MRCH.R6.ZS	Merchandise exports to low- and middle-income economies in Sub-Saharan Africa (% of total merchandise exports)
TX.VAL.MRCH.RS.ZS	Merchandise exports by the reporting economy, residual (% of total merchandise exports)
TX.VAL.MRCH.WL.CD	Merchandise exports by the reporting economy (current US$)
TX.VAL.MRCH.WR.ZS	Merchandise exports to low- and middle-income economies within region (% of total merchandise exports)
TX.VAL.MRCH.XD.WD	Export value index (2000 = 100)
TX.VAL.OTHR.ZS.WT	Computer, communications and other services (% of commercial service exports)
TX.VAL.SERV.CD.WT	Commercial service exports (current US$)
TX.VAL.TECH.CD	High-technology exports (current US$)
TX.VAL.TECH.MF.ZS	High-technology exports (% of manufactured exports)
TX.VAL.TRAN.ZS.WT	Transport services (% of commercial service exports)
TX.VAL.TRVL.ZS.WT	Travel services (% of commercial service exports)
WP15163_4.2	Mobile account, male (% age 15+) [w2]
WP15163_4.3	Mobile account, female (% age 15+) [w2]
WP_time_01.2	Account at a financial institution, male (% age 15+) [ts]
WP_time_01.3	Account at a financial institution, female (% age 15+) [ts]
